{
    "tileset" :"brouillard.png",
    "terrain" : [
        [0, 0, 0, 0, 0, 0, 0, 0, 0,  0,  0,  0,  0,  0,  0, 2,  3,  3,  3,  3,  3],
        [0, 0, 0, 0, 0, 0, 0, 0, 0,  0,  0,  0,  0,  0,  2, 3,  3,  3,  3,  3,  3],
        [0, 0, 0, 0, 0, 0, 0, 0, 0,  0,  0,  0,  0,  2,  3, 3,  3,  3,  3,  3,  3],
        [3, 3, 3, 3, 3, 3, 3, 3, 3,  3,  3,  3,  3,  3,  3, 3,  3,  3,  3,  3,  3],
        [3, 3, 3, 3, 3, 3, 3, 3, 3,  3,  3,  3,  3,  3,  3, 3,  3,  3,  3,  3,  3],
        [3, 3, 3, 3, 3, 3, 3, 3, 3,  3,  3,  3,  3,  3,  3, 3,  3,  3,  3,  3,  3],
        [3, 3, 3, 3, 3, 3, 3, 3, 3,  3,  3,  3,  3,  3,  3, 3,  3,  3,  3,  3,  3],
        [3, 3, 3, 3, 3, 3, 3, 3, 3,  3,  3,  3,  3,  3,  3, 3,  3,  3,  3,  3,  3],
        [3, 3, 3, 3, 3, 3, 3, 3, 3,  3,  3,  3,  3,  3,  3, 3,  3,  3,  3,  3,  3],
        [3, 3, 3, 3, 3, 3, 3, 3, 3,  3,  3,  3,  3,  3,  3, 3,  3,  3,  3,  3,  3],
        [3, 3, 3, 3, 3, 3, 3, 3, 3,  3,  3,  3,  3,  3,  3, 3,  3,  3,  3,  3,  3],
        [3, 3, 3, 3, 3, 3, 3, 3, 3,  3,  3,  3,  3,  3,  3, 3,  3,  3,  3,  3,  3],
        [3, 3, 3, 3, 3, 3, 3, 3, 3,  3,  3,  3,  3,  3,  3, 3,  3,  3,  3,  3,  3],
        [3, 3, 3, 3, 3, 3, 3, 3, 3,  3,  3,  3,  3,  3,  3, 3,  3,  3,  3,  3,  3],
    [3, 3, 3, 3, 3, 3, 3, 3, 3,  3,  3,  3,  3,  3,  3, 3,  3,  3,  3,  3,  3],
    [3, 3, 3, 3, 3, 3, 3, 3, 3,  3,  3,  3,  3,  3,  3, 3,  3,  3,  3,  3,  3],
 
        [3, 3, 3, 3, 3, 3, 3, 3, 3,  3,  3,  3,  3,  3,  3, 3,  3,  3,  3,  3,  3]
    ]
}